16,16
...........@....
...............@
.....@..........
.........@......
................
......@..@@.....
.........@......
...@.@...@......
................
....@.......@.@.
......@.........
.....@....@....@
................
........@...@...
........@.....@.
..@.....@...@...
