8,8
.@......
........
..@.@...
........
...@@...
..@.....
........
........
