22,22
@@@@@@@@@@@@@@@@@@@@@@
@.........@...@......@
@.@..................@
@.@.@...@.........@..@
@..@.......@.........@
@.......@..........@.@
@................@.@.@
@..............@.@...@
@...................@@
@...................@@
@........@....@..@..@@
@....@...............@
@.......@.@@@......@.@
@..................@@@
@..@........@......@.@
@...........@.@......@
@.....@...@..........@
@............@.......@
@....................@
@.....@.@............@
@...................@@
@@@@@@@@@@@@@@@@@@@@@@